10 10
_ _ _ _ _ _ W C C _ 
_ _ _ _ _ _ W _ _ _ 
_ _ _ _ _ _ W _ _ _ 
_ _ _ _ _ _ W _ _ _ 
_ _ _ _ _ _ _ _ _ _ 
_ _ _ _ _ _ _ _ _ _ 
_ _ _ _ _ _ _ _ _ _ 
_ _ _ _ _ _ _ _ _ _ 
_ _ _ _ _ _ _ _ _ _ 
_ _ _ _ _ _ _ _ _ D 
