10 10
_ _ _ _ _ _ _ _ _ C 
_ _ _ _ _ _ _ _ _ _ 
_ _ _ _ _ W _ _ _ _ 
_ _ _ _ _ W W _ _ W 
_ _ _ _ _ W _ _ _ C 
W _ _ W W W _ _ _ _ 
_ _ _ _ _ W _ _ _ _ 
_ _ _ _ _ W _ _ _ _ 
_ _ _ _ _ _ _ _ _ _ 
_ _ _ _ _ _ _ _ _ D 
