10 10
_ _ _ C _ _ W _ C _ 
_ _ _ _ _ _ W _ _ _ 
_ _ _ _ _ _ W _ _ _ 
_ _ _ _ _ _ W _ _ _ 
_ _ _ W W W W _ _ _ 
_ _ _ _ _ _ _ _ _ _ 
_ _ _ _ _ _ _ _ _ _ 
W W W W W W _ _ _ _ 
_ _ _ _ _ W _ _ _ _ 
C _ _ _ _ _ _ _ _ D 
