10 10
_ _ _ _ _ _ _ _ _ _ 
_ _ W W W W W _ _ _ 
_ _ W _ _ C W _ _ _ 
_ W W D _ _ W W _ _ 
_ W _ _ _ _ _ _ _ _ 
_ W C _ _ _ _ _ _ _ 
_ W W W W _ _ _ _ _ 
_ _ _ _ W _ _ _ _ _ 
_ _ _ _ _ _ _ _ _ _ 
_ _ _ _ _ _ _ _ _ _ 
