10 10
_ _ _ _ _ _ _ _ _ _ 
_ _ W W W W W W _ _ 
_ _ W _ _ C _ W _ _ 
W W W _ _ _ _ W _ _ 
_ _ _ _ _ _ _ W _ _ 
_ _ W W W _ _ W _ _ 
_ _ W D _ _ _ W _ _ 
_ _ W W W W W W _ _ 
_ _ _ _ _ _ _ _ _ _ 
_ _ _ _ _ _ _ _ _ _ 
