10 10
_ _ _ _ _ _ _ _ _ _ 
_ _ _ _ _ _ _ _ _ _ 
_ _ _ _ _ W _ _ _ _ 
_ _ _ _ _ W _ _ _ _ 
W W W W W W W W _ _ 
_ _ _ _ C W _ _ _ _ 
_ _ _ _ _ W _ _ _ _ 
_ _ W W W W _ _ _ _ 
_ _ _ _ _ _ _ _ _ _ 
D _ _ _ _ _ _ _ _ _ 
