8 8
_ _ _ _ _ _ _ _ 
_ _ _ _ _ _ _ _ 
_ _ _ _ _ _ _ _ 
W W W W _ W W W 
_ _ _ _ _ _ _ _ 
_ _ _ _ _ _ _ _ 
_ _ _ _ _ _ _ _ 
C _ _ _ _ _ _ _ 
