10 10
S _ _ _ _ _ _ _ _ C 
_ _ _ _ _ _ _ _ _ _ 
_ W _ _ _ D D _ _ _ 
_ W _ _ _ _ _ _ _ _ 
_ _ _ _ _ _ _ _ _ C 
_ _ _ _ _ _ _ _ _ _ 
_ _ _ _ _ _ W _ _ _ 
_ _ _ _ _ _ _ _ _ _ 
_ _ _ _ _ _ _ _ _ _ 
_ _ _ _ _ _ _ _ _ F 
