10 10
_ _ _ _ W _ _ _ _ _ 
_ _ _ _ W _ _ _ _ _ 
_ _ _ _ W _ _ _ W _ 
_ _ _ _ _ _ _ W _ _ 
W W W _ _ _ W _ _ _ 
_ _ _ _ _ W C _ _ _ 
_ _ _ _ W _ _ _ _ _ 
_ _ _ W _ _ _ _ _ _ 
_ _ _ _ _ _ _ _ _ _ 
_ _ _ _ _ _ _ _ _ D 
